T------------------------------------------------------------------------------------------------------------------------------------------------------------------------------------------------------E
-------------------------------------------------------------------------------------------------------------------------------------------------------------------------------------------------------v
?------------------------------------------------------------------------------------------------------------------------------------------------------------------------------------------------------o
|------------------------------------------------------------------------------------------------------------------------------------------------------------------------------------------------------o
?------------------------------------------------------------------------------------------------------------------------------------------------------------------------------------------------------o
o------------------------------------------------------------------------------------------------------------------------------------------------------------------------------------------------------f
-------------------------------------------------------------------------------------------------------------------------------------------------------------------------------------------------------|
o------------------------------------------------------------------------------------------------------------------------------------------------------------------------------------------------------v
v------------------------------------------------------------------------------------------------------------------------------------------------------------------------------------------------------T
B------------------------------------------------------------------------------------------------------------------------------------------------------------------------------------------------------|
E?o-B-Mo-ooo??o----B-?B?-?o-B-MMM?o-?-M--Bo-B----ooM-----EooBE-o-o?M-o-??-o------Moo-E-MM?M-?o---Boo--oo-oooBMo-o--?-oM-o--?-oMBTME?-?M--?--o---oM---E-------Bo--EoB--?B-B-?-M-M--?oM-EM---o?BMBBM-E-M-f
Eo--M---?E--MB--Eo--Boo?M?M---B?M--MBo---?B-o?E?-Moo?-M-?-M??--oo---E-BoEB-o-M-o-o-M-M-E-MEEMM-E?---o---?-Mo-o---B??MooB-ooo---E-o?M-M-MooM?o-B-EE--BM--M-----o-Mo-oM--ooM-EE----oM-EM-B?BBo?o?Bo?--B?oT
o-M?-M-ooM?-o---oM-M--ooB-oo--o-o-o?Eo-o----M-Mo-Eoo--B?Mo?-M-oBo-o-o?M--MB--E?B--?--EMM-----o---o-BM--oo--?oo--o-M-?BBMoMMMBB-oo?-o?-oMEB-M-MM-??--Bo-Mo--B-Mo-M-??-oBo?-?o-B-ooo--???Bo-o?Mo-M-Mo-ooT|
o--?ooo?MMMoBM?-----ooMB---BE?B-ooM-?---B-o?MB-B-o?-o-o--oBoM-B?---o--B-?BM-?o--BM---o-?ooMMME---oM-?-ooB-?---MoMMo--B??oM??oB---o--?--o---?o?--?ooo?MB-M?----?---B?-B---M-oooooo--MBB-oB-Bo-B-o--o-EBMM
m----T--o-B-T-o--------------------------T---B----ToB----E-M-T-o-T-M---------M?ooT-----??-M----T----o---T---M------?o-?-T?---B?T---Bo--E--?M----o--------oo--o-o--T--M--T----E------M-T-T?--B---MT-----E
X|XX||XXXXXXX-XX---X-X-XXX-|-|XXXX|-X-|-X|---X||XX||--XXX-|XX|XXX|XX|X|XX-X-X-X-|||--XXX|XXXX-XXX-||XX|||-XX-XX|-XX-XXXX|XX-XX--|X-XX|-XXXX|X-|XXX|X---XXX|XX--|-X|XX-|X|-XX-XX-X-|-XX|-|X|X-X-|X||X--XX
