B------------------------------------------------------------------------------------------------------------------------------------------------------------------------------------------------------|
E------------------------------------------------------------------------------------------------------------------------------------------------------------------------------------------------------X
B------------------------------------------------------------------------------------------------------------------------------------------------------------------------------------------------------f
f------------------------------------------------------------------------------------------------------------------------------------------------------------------------------------------------------X
B------------------------------------------------------------------------------------------------------------------------------------------------------------------------------------------------------T
f------------------------------------------------------------------------------------------------------------------------------------------------------------------------------------------------------E
T------------------------------------------------------------------------------------------------------------------------------------------------------------------------------------------------------E
|------------------------------------------------------------------------------------------------------------------------------------------------------------------------------------------------------v
f------------------------------------------------------------------------------------------------------------------------------------------------------------------------------------------------------B
M------------------------------------------------------------------------------------------------------------------------------------------------------------------------------------------------------?
v-E--vo-BBB-BTEoB-BEBMoBooBMEE-o?oE?M-oBMB----E-BB?-ooM?ooEoBoBMM??ooBM|B-BM--o-T--X--o--?M?o-o--Bo-B-MBM?-?-oB-?--TB-oEo?BBooo?--oBo-BB--TM-B-EBEoBo-|-oTM-ooE-?----oEo-Too??Mo-T-E-B??MMME-oooM?oo?MXM
M---MXMvBMM-M|-?oEMB--M-E-oovo?BEo--T?-B?M--o-Mo-EMMoMMBo-BoE-o-E?T?--B--oETM-of?X-B??Bo-o?o-B-o-M-f-BMo?foMoEv|-EB??o?-o?MB-E-?M?-BovM-oBoEM?---oEBT-E?BMEB?o-BM-?M--??M|TE?o-ME--oM?-?B-BETToooo??Mo-B
Eo-oo-B-M-o-o?EBo-E?--B?Bo?-M?ofXME-M-M-B?-M?BT-MM-Mo--X?MoM?B?-?E|-o?o?--ovE-B?Eo-ooX--?Bf-EoB---X?o--oo-BoMX?MMM---o-BMB-oMo-M-ooo-ooM?-E?--ooMoMo--MB-?oMooE?BE?-ooM--EEMBM-o??-?-BoBEB---EooM-?-E-v?
|-?--E--E---o?Mo-?-Mo----EooBMMM--oMB----BEM-B?B??o-oME-MM?o-Ef|oo--oBo?BoBM--BB--E-B-MMMoBfo?-v-o??o-o-MoX-?XMoMoEoBMBooTfBoM???oo--Eo--?MEMMBfB-B-o-BoBMM?B?BEE--BB?oo-B-M---EB-BB-MBM?oo??Eo-f-oMB-|o
m-------------------------------------------------------------------------------------------------------------------------------------------------------------------------------------------------------
XXX-XXXXXX||XXXXXX--X-XXXXXXX||X||XXXXXXX--X|XXXXX|XX--XX|X|XXXX---X|X-XXXXX-XX|XX--|-XXX|-XXXX|--XX|-|XX-XXXXXX-XX-X||--XXXX-XXXXXXXXX|XXXXXXX-XXXX-X|XXXXXX|XXXX---X-XXXXXXXXX---XX-|X--XX--|XX|XX-XXX
