--------------------------------------------------------------------------------------------------------------------------------------------------------------------------------------------------------
--------------------------------------------------------------------------------------------------------------------------------------------------------------------------------------------------------
--------------------------------------------------------------------------------------------------------------------------------------------------------------------------------------------------------
--------------------------------------------------------------------------------------------------------------------------------------------------------------------------------------------------------
--------------------------------------------------------------------------------------------------------------------------------------------------------------------------------------------------------
--------------------------------------------------------------------------------------------------------------------------------------------------------------------------------------------------------
--------------------------------------------------------------------------------------------------------------------------------------------------------------------------------------------------------
--------------------------------------------------------------------------------------------------------------------------------------------------------------------------------------------------------
--------------------------------------------------------------------------------------------------------------------------------------------------------------------------------------------------------
-------------------------------------------------------------------------------------------------------------------------------------------------------------------------------------------------------v
-----------B--oM-o---oBE--B-?-B-B--oMB??MB?--Bo-oBM-o-Boo--o--o-o---EBB--o-?-----oMM-EMoBM-B-?oE-M----M----M?B-----B--oo--o-o--MB--Bo-o-o-o---?o-B--?oMMo----oB---BoM--oB-?---?EEo-o--?-----?--?oo-B??-f
------------oEM------B-B?BMM----BoM?---?-M----M-B-B-B-?-B?-oBo-M-o?MME---Mo-B??ooB--B---BBoB----o-?--oBo?MMoE-Eo?o----B--ooB-?---ooBo?M--oB-M--Bo?-BoB?-BBB-----BMoB-o---o-B-oB---M-?----o--B-?-----o--f
------------EB--oM--EE-Moo---M--E?EM-M-?-o---B-?-----oMM?Bo?--oo-Eo-B-?B?---o-MoMBo-oM------oMo-oB?E?o-E--E---B--E-Eo--B-o----??---o--oMo-oo-?-E-M--EE--oo?Bo--oM--BM-o--oE-E?oo---Mo-EMM--BoB------B--f
------------MoB-o-----E-ME-M----E---MB-BB?oBo-E--?-M-B--?MMooM?------B--B----o-?--o-Mo------B-BB-ooB--oME--------M-E---E--??oB?-o---oo-BM-Bo?MBMB---o-o-?-M-o-o?----o?oo-o---o--MoB--B?o---??-?--o-----f
m--------------TT?----------M?----To-----MB-B-o---?------------oM-TEB--o-T-M-B---------M-o-------------T-E-oE---o--o--------B------T--B--------------?---TE----T--o----o-------M---?---TB-TTT-B---o----X
XX-X|XXX|X-XX|X||X|XXXX--|XXX--X-X|X---XXXXXXX-XX-XXXX--|XXX|XXX-XXXX-|X--X-XX-XX|-X-X-XXX-XXX-|XXXXX-XXXX--X--|--XXXX-XXXXX-X-X|XX-|XXX|-XXX-XXXX-X-XXXXX||X--|-|XX|XX--|XXX||X----|X|XX-|||----X-XXXXX
