----------------------------------B---------------------------------------------------------------------------------------------------------------------------------------------------------------------
--------------------------------------------------------------------------------------------------------------------------------------------------------------------------------------------------------
-------------------------------------------------------------------------BBBBBB-------------------------------------------------------------------------------------------------------------------------
--B-----------------------------------------------------------------------------------------------------------------------------------------------------------------------------------------------------
----------------------------------------------------------------o-----------------------------------------------?---------------------------------------------------------------------------------------
----------------------------------------------------------M----------o----------------------------------------------------------------------------------------------------------------------------------
--------------------------------------------------------------------------------------------------------------------------------------------------------------------------------------------------------
-------------------------------------------------------------------------X-----------------------------------------------------------------------------------------------------------------------------v
------------------------------------------------------------------------XX----------------------------------------------------------------------------------------------------XXXXX------X-------------f
-----------------------------------------------------------------------XXX--------------------------------------------------------------------------------------------------------------XX-------------f
----------------------------------------------------------------------XXXX-------------------------------------------------------------------------------------------------------------XXX-------------f
---------------------------------------------------------------------XXXXX----------------------M-------------------------------------------------------------------------M-----------XXXX-------------f
--------------------------------------------------------------------XXXXXX-----------------------------------------------------------------------------------------------------------XXXXX-------------f
-------------------------------------------------------------------XXXXXXX--------B-------------------------------------------------------------------------------------------------XXXXXX-------------f
m------------?-------------------------------------E--------------XXXXXXXX---------------------------------------------------------------------------------------------------??----XXXXXXX-------------X
XXXXXXXXXXXXXXXXXXXXXXXXXXXXXXXXXXXXXXXXXXXXXXXXXXXXXXXXXXXXXXXXXXXXXXXXXXXXXXXXXXXXXXXXXXXXXXXXXXXXXXXXXXXXXXXXXXXXXXXXXXXXXXXXXXXXXXXXXXXXXXXXXXXXXXXXXXXXXXXXXXXXXXXXXXX---XXXXXXXXXXXXXXXXXXXXXXXXXX
