----------------------------------------------------------------------------------B---------------------------------------------------------------------------------------------------------------------
--------------------------------------------------------------------------------------------------------------------------------------------------------------------------------------------------------
----------------------------------------------------------------------------------------------------------------------------------------------------------BBBB------------------------------------------
--------------------------------o-----------------------------------------------------------------------------------------------------------------------------------------------------------------------
--------------------------------------------------------------------------------------------------------------------------------------------------------------------------------------------------------
-------------------------------BBBBBBB------------------------------------------------------------------------------------------------------------------------------------------------------------------
---------------------------o------------------------------------------------------------------------------------------------X---------------------------------------------------------------------------
--------------------------------XXXXXXXX-----------------------------------------------------------------------------------XX--------------------------------------------------------------------------v
---------------------------M----------------------------------------------------------------------------------------------XXX--------------------------------------------------------------------------f
-------------------------------------------------------------------------------------------------------------------------XXXX--------------------------------------------------------------------------f
------------------------------------------------------------------------------------------------------------------------XXXXX-------------------------------------o------------------------------------f
-----------------------------------------------------------------------------------------------------------------------XXXXXX--B-----------------------------------------------------------------------f
---------------------------------------------------------------------------------------------------------------------BXXXXXXX--------------------------------------------------------------------------f
-------------------------------------------------------------BBBBBBB------------------------o------------------------XXXXXXXX--------------------------------------------------------------------------f
m-----------------------------------------------------------------------------------------------------------------E-XXXXXXXXX---------------------------------E---------------E------------------------X
XXXXXXXXXXXXXXXXXXX---XXXXXXXXXXXXXX-XX----XXXXXXX?XXXXXXXXXXXXXXXXXXXXXXXXXXXXXXXXXXXXXXXXXXXXXXXXXXXXXXXXXXXXXXXXXXXXXXXXXXXXXXXXXXXXXXXXXXXXXXXXXXXXXXXXXXXXXXXXXXXXXXXXXXXXXXXXXXXXXXXXXXXXXXXXXXXXX
