--------------------------------------------------------------------------------------------------------------------------------------------------------------------------------------------------------
--------------------------------------------------------------------------------------------------------------------------------------------------------------------------------------------------------
--------------------------------------------------------------------------------------------------------------------------------------------------------------------------------------------------------
--------------------------------------------------------------------------------------------------------------------------------------------------------------------------------------------------------
--------------------------------------------------------------------------------------------------------------------------------------------------------------------------------------------------------
--------------------------------------------------------------------------------------------------------------------------------------------------------------------------------------------------------
--------------------------------------------------------------------------------------------------------------------------------------------------------------------------------------------------------
--------------------------------------------------------------------------------------------------------------------------------------------------------------------------------------------------------
--------------------------------------------------------------------------------------------------------------------------------------------------------------------------------------------------------
-------------------------------------------------------------------------------------------------------------------------------------------------------------------------------------------------------f
-ooo--oM--o-E?-Bo-BMB--B-B-BMoMoBMM?-oEo--oMoEB--M?-oMo-?o-?MM--BMB?----o?MM?---o----??MoB?o--?-MM??o?M??--EBE?EoM-B-B----E-M-?B---o---o-M--?M----EoE-Bo-B-BE-MMo-E?-EBB--o--oMB-oM-E?MoB-B-oMBB-Bo-?--v
-MEoo--?E?B???o--oo---BM?-E--Boo?oo--MM-oo?M?---Mo-o--BBB?--M?--o?BoE-o--oo---M-oooMM--?Moo--?EB--B--M?-o---o?EoEBM--?-o--MEo-o-M---E-E-oEBMBB----?-EB?M---??o???oM-?o--o----MMB-B--EooBo--??---?B--B-Bv
----M-B-E-??MBo---B--??o---oo-E-M?-EMo?BME-oB?E-?o?M-?E???o--?BBEM-Bo-?E?-o---B?oMo-M?o??-o-o---o--oB--?B-oo-o?-?oBB?oMoB-o-----oo?oB-o-B-MMM?-oM-EBMM---B?--o?-MM---M?-BoE-?-B--ooBBM----B??-o?--ooB-Bv
--?M-o----B-M-B--o?B-E???o-o--?EM--oE?------E-oEMo?-BBBo--o--oBM-oo-?Mo-MooMBM-oE?-o--oM-BoMBoE-BM-o-o-oo?B-E----BM-Mo?--oM-?oMMM--o-o--BE--Bo-oBo?--Moo?-B?o--?Mo-?--EBB-MM-?---?-oM-o----o?M-B----?-ov
m-o-B-?---------T---o--?--?oT-oo--TT?------M--T------M-M-M--B-----------o-----T---MM---o--o?oT-----E---To--M---To-oT-?--B--TB------M----T--M--------B--B----------------------B-o-------B--------M-TTo-X
X|-XXX--X|-|XX-X|||X|--|--XX||--X-||X-XX---|X|XX--|-|--|-XXX|-|-XX-X-XX---||X-|X--|X---XXX--X||XX--XXX||XX--XX-|--X|-X|X-|-|XX--X-XX|X--XXXX---|XX|XXXXX|-XXX|-X|XX-|XX|-XXX--XX|--|-|X-X|-|--X-XXX||XXX
